8 4 8
10000000
01000000
00100000
00010000
00001000
00000100
00000010
00000001
-
00000000
11110000
00000000
00000000
00000000
11110000
00000000
00000000
-
00000000
00110000
11110000
00000000
00000000
11110000
00000000
00000000
-
00000000
00000000
00000000
00000000
00000000
00000000
00000000
00000000
-
